Male	Female
abah	emak
ayah	bunda
ayahanda	ibunda
bapak	ibu
cowok	cewek
ganteng	cantik
kakek	nenek
karyawan	karyawati
laki-laki	perempuan
pria	wanita
jejaka	gadis
mas	mbak
olahragawan	olahragawati
om	tante
opa	oma
pakde	bude
paman	bibi
papa	mama
papah	mamah
papi	mami
peragawan	peragawati
perjaka	perawan
raja	ratu
sastrawan	sastrawati
suami	istri
wartawan	wartawati
wisudawan	wisudawati
