Province	Capital
Babel	Pangkalpinang
Bali	Denpasar
Banten	Serang
Bengkulu	Bengkulu
Gorontalo	Gorontalo
Jabar	Bandung
Jambi	Jambi
Jateng	Semarang
Jatim	Surabaya
Kalbar	Pontianak
Kalsel	Banjarmasin
Kaltim	Samarinda
Kepri	Tanjungpinang
Maluku	Ambon
Malut	Sofifi
NTB	Mataram
NTT	Kupang
Pabar	Manokwari
Papua	Jayapura
Riau	Pekanbaru
Sulbar	Mamuju
Sulsel	Makassar
Sulteng	Palu
Sultra	Kendari
Sulut	Manado
Sumbar	Padang
Sumsel	Palembang
Sumut	Medan
Yogyakarta	Yogyakarta
