Singular	Plural
adik	adik-adik
anak	anak-anak
bapak	bapak-bapak
batu	batu-batu
boneka	boneka-boneka
buku	buku-buku
cermin	cermin-cermin
daun	daun-daun
gedung	gedung-gedung
ibu	ibu-ibu
kakak	kakak-kakak
kantor	kantor-kantor
kata	kata-kata
kayu	kayu-kayu
kertas	kertas-kertas
kucing	kucing-kucing
kuda	kuda-kuda
kursi	kursi-kursi
meja	meja-meja
mobil	mobil-mobil
rumah	rumah-rumah
sayur	sayur-mayur
